0,0,0,0,0,0,0,0,0,0,0,0,0,0,0,0,0,0,0,0
0,0,0,0,0,0,0,0,0,0,0,0,0,0,0,0,0,0,0,0
0,0,0,0,0,0,0,0,0,0,0,0,0,0,0,0,0,0,0,0
0,0,0,1,2,0,0,0,0,0,0,0,0,0,0,0,0,0,0,0
0,0,0,2,0,0,0,7,8,0,0,0,3,3,0,0,7,8,0,0
0,0,2,0,0,0,0,9,10,0,0,0,0,0,0,0,9,10,0,0
0,0,0,0,0,0,0,0,0,0,0,0,0,0,0,0,0,0,0,0
0,0,0,0,0,6,0,0,0,0,0,0,0,0,0,0,0,0,0,0
0,0,0,0,0,6,0,0,0,0,6,0,0,7,8,0,0,0,0,0
0,0,0,0,1,6,0,1,1,2,6,0,0,9,10,0,0,0,0,0
0,2,0,0,0,2,1,1,1,0,6,0,0,0,0,0,0,0,0,0
0,1,0,0,0,0,1,0,0,0,6,0,0,0,13,0,0,0,0,0
1,0,1,0,0,0,0,0,0,0,0,12,0,7,8,0,0,0,0,0
0,1,0,0,0,0,0,0,0,0,0,0,0,9,10,0,7,8,0,0
0,0,0,13,12,0,6,2,0,0,7,8,0,0,0,0,9,10,0,0
0,7,8,4,4,0,0,1,2,0,9,10,0,0,0,0,0,0,0,0
0,9,10,3,3,3,3,1,1,1,0,0,0,0,0,0,7,8,0,0
0,0,0,0,0,3,3,3,0,0,0,0,11,12,0,0,9,10,0,0
0,0,0,0,0,0,0,1,0,0,0,0,11,0,0,0,0,0,0,0
13,2,0,0,0,0,0,0,0,0,0,0,0,0,0,0,0,0,0,6
0,0,5,0,0,11,0,0,0,0,0,0,0,0,0,0,0,0,0,6
0,5,5,0,0,0,0,0,0,0,0,2,0,0,4,4,4,0,0,6
0,5,0,0,0,0,0,0,0,0,1,1,0,0,0,7,8,0,0,0
0,0,0,0,0,0,5,0,0,0,0,2,1,0,0,9,10,0,0,0
0,0,0,0,0,0,5,0,0,0,2,0,0,2,2,0,0,0,0,0
0,0,0,0,0,0,0,0,0,0,13,3,0,1,5,0,0,0,0,0
0,0,7,8,0,0,0,0,0,0,0,0,0,0,5,0,0,0,0,0
4,0,9,10,7,8,0,0,0,0,0,0,0,0,5,0,0,3,0,4
0,0,0,0,9,10,0,0,0,0,6,0,0,0,5,0,0,0,0,0
0,0,0,0,4,0,0,0,0,0,6,5,0,0,0,0,0,0,0,0
0,0,0,0,0,0,7,8,0,0,6,5,0,0,0,0,0,0,0,0
0,0,0,0,0,0,9,10,0,6,6,5,0,0,0,0,0,0,0,0
0,0,0,0,0,0,0,0,0,6,0,5,0,0,0,3,3,3,3,0
0,0,0,0,0,0,0,0,0,0,0,0,0,0,0,0,0,0,0,0
0,0,0,0,0,0,0,0,0,0,0,0,0,0,0,0,0,0,0,0
0,0,0,0,0,0,0,0,0,0,0,0,0,0,0,0,0,0,0,0