0,0,0,0,0,0,0,0,0,0,0,0,0,0,0,0,0,0,0,0
0,0,0,0,0,0,0,0,0,0,0,0,0,0,0,0,0,0,0,0
0,0,0,0,0,0,0,0,0,0,0,0,0,0,0,0,0,0,0,0
0,0,0,2,2,1,2,2,1,1,0,0,0,0,0,0,0,0,0,0
0,0,0,2,0,0,0,0,0,0,0,0,0,0,0,5,4,0,6,0
0,0,0,0,0,0,0,0,0,0,6,6,0,0,0,5,0,0,6,0
0,0,0,0,0,0,0,0,0,0,6,6,0,0,0,5,0,0,6,0
0,0,0,0,0,0,0,0,0,0,6,6,0,0,0,0,0,0,6,0
0,0,0,0,0,0,0,0,0,6,6,0,0,0,1,0,0,7,8,0
0,0,7,8,0,0,0,0,0,6,11,7,8,2,2,7,8,9,10,0
0,0,9,10,0,0,0,0,0,6,0,9,10,0,0,9,10,6,0,0
0,0,0,0,0,0,0,0,0,6,0,0,0,0,1,0,0,0,0,0
0,0,0,0,0,0,0,0,0,0,0,0,0,2,0,0,0,0,0,0
0,0,0,0,4,4,4,0,0,0,0,0,0,0,0,0,0,0,0,0
0,0,0,11,0,0,0,0,0,7,8,0,0,0,0,0,0,0,0,0
0,0,0,0,0,0,0,0,0,9,10,0,0,0,7,8,0,0,0,0
4,4,4,4,0,0,0,0,0,0,0,0,0,0,9,10,0,3,3,4
0,0,0,0,5,3,3,7,8,0,0,5,0,6,0,0,0,0,0,0
0,0,0,0,5,0,0,9,10,11,0,5,0,6,7,8,0,0,0,0
0,0,6,0,13,7,8,13,0,0,0,5,0,6,9,10,0,0,0,0
0,0,6,7,8,9,10,0,0,0,0,5,0,6,0,12,0,0,0,0
7,8,0,9,10,0,0,0,0,11,0,0,0,0,0,0,0,0,0,0
9,10,0,0,0,1,0,0,0,0,0,0,0,0,0,0,0,7,8,0
0,0,0,0,0,2,0,0,0,1,0,2,11,0,0,0,0,9,10,0
0,0,0,0,0,0,0,0,0,2,2,0,6,1,0,0,0,0,0,0
0,0,0,0,6,0,0,0,0,0,0,0,6,1,0,1,0,0,0,6
0,0,5,0,6,7,8,0,0,0,0,0,6,2,2,0,0,1,1,6
0,0,5,0,6,9,10,13,0,0,0,0,6,1,0,0,0,0,0,0
0,0,0,0,6,4,0,0,2,0,0,0,6,0,0,0,0,0,0,0
0,0,0,0,0,0,0,0,2,0,0,0,6,0,0,0,0,0,0,0
0,0,0,0,0,0,0,0,1,2,5,0,6,0,0,0,0,0,0,0
0,0,0,0,0,0,0,2,1,0,5,0,0,0,0,0,0,0,0,0
0,0,0,0,0,0,1,1,0,0,0,0,0,0,0,0,0,0,0,0
0,0,0,0,0,0,0,0,0,0,0,0,0,0,0,0,0,0,0,0
0,0,0,0,0,0,0,0,0,0,0,0,0,0,0,0,0,0,0,0
0,0,0,0,0,0,0,0,0,0,0,0,0,0,0,0,0,0,0,0