0,0,0,0,0,0,0,0,0,0,0,0,0,0,0,0,0,0,0,0
0,0,0,0,0,0,0,0,0,0,0,0,0,0,0,0,0,0,0,0
0,0,0,0,0,0,0,0,0,0,0,0,0,0,0,0,0,0,0,0
0,0,0,0,0,0,0,0,0,0,0,6,0,0,0,0,3,0,0,0
0,0,0,6,0,0,0,0,0,0,0,0,0,0,0,0,0,0,0,0
0,0,0,0,0,0,0,0,0,2,2,2,0,0,0,0,0,0,0,0
0,0,0,0,0,0,0,0,0,0,2,1,2,0,0,0,0,4,4,0
0,0,0,4,0,0,0,0,0,0,2,2,1,0,0,0,0,0,0,0
0,0,0,0,0,0,0,0,0,0,0,0,4,0,1,0,0,0,0,0
0,0,0,0,0,0,0,0,0,0,0,0,0,0,0,0,0,0,5,0
0,0,0,0,0,0,7,8,0,0,0,0,0,0,0,0,0,0,5,0
0,0,0,0,0,0,9,10,1,0,0,0,0,0,0,0,0,0,5,0
0,0,0,0,4,0,1,0,4,4,4,4,0,0,0,0,0,0,0,0
0,7,8,4,4,4,0,2,2,12,0,0,0,5,5,12,0,0,0,0
0,9,10,0,0,0,0,0,0,0,0,0,0,5,5,0,0,0,0,0
0,7,8,0,0,0,0,0,0,6,0,13,0,5,0,7,8,0,0,0
0,9,10,4,0,0,0,0,0,6,0,0,0,5,0,9,10,0,0,0
0,2,0,2,0,0,0,0,0,6,0,0,0,0,0,0,0,0,0,0
0,0,1,1,0,0,0,0,0,6,0,0,12,0,0,0,0,0,0,0
0,0,2,2,0,0,0,0,0,3,3,3,3,0,0,0,0,0,0,0
0,0,0,0,0,0,0,0,0,0,0,0,0,1,0,0,0,0,0,0
0,7,8,0,0,0,0,0,0,0,12,0,7,8,0,0,0,0,0,0
0,9,10,0,0,0,0,7,8,0,0,0,9,10,5,0,0,7,8,0
0,0,0,0,0,0,0,9,10,0,0,0,0,0,5,0,11,9,10,0
0,0,0,0,0,0,0,0,0,0,0,0,0,0,0,0,0,0,0,0
0,0,12,0,0,0,2,0,0,0,0,0,0,7,8,0,0,0,0,0
7,8,0,11,11,1,1,0,0,0,0,0,0,9,10,0,0,0,0,0
9,10,1,2,0,2,1,0,0,0,0,11,0,0,0,0,0,0,0,0
0,0,0,4,1,2,2,5,0,0,4,4,4,7,8,0,0,5,0,0
7,8,0,0,0,0,0,5,0,0,7,8,0,9,10,0,0,5,0,0
9,10,0,0,0,0,0,5,0,0,9,10,0,0,0,0,0,5,0,0
0,0,6,0,0,0,0,0,0,0,0,0,0,0,0,0,0,0,0,0
0,0,0,0,0,0,0,0,0,0,0,0,0,0,6,0,0,0,0,0
0,0,0,0,0,0,0,0,0,0,0,0,0,0,0,0,0,0,0,0
0,0,0,0,0,0,0,0,0,0,0,0,0,0,0,0,0,0,0,0
0,0,0,0,0,0,0,0,0,0,0,0,0,0,0,0,0,0,0,0